######%%##%%##%%##%%##%%##%%###
# @ #   #   #   #   #   #   #=#
#   # # # # # # # # # # # # # #
#     #   #   #   #   #   #   #
####%%##%%##%%##%%##%%##%%##%%#
