##################
# @        #=    #
#%%%###### ##### #
#   #    # #   # #
#   ###### ##### #
#                #
##################